#define GOTCLIP	"Picked up a clip."
#define GOTCLIPBOX	"Picked up a box of bullets."
#define GOTCHAINGUN	"You got the chaingun!"

#define GOTSHELLS	"Picked up 4 shotgun shells."
#define GOTSHELLBOX	"Picked up a box of shotgun shells."
#define GOTSHOTGUN	"You got the shotgun!"
#define GOTSHOTGUN2	"You got the super shotgun!"

#define GOTROCKET	"Picked up a rocket."
#define GOTROCKBOX	"Picked up a box of rockets."
#define GOTLAUNCHER	"You got the rocket launcher!"

#define GOTCELL	"Picked up an energy cell."
#define GOTCELLBOX	"Picked up an energy cell pack."
#define GOTPLASMA	"You got the plasma gun!"
#define GOTBFG9000	"You got the BFG9000!  Oh, yes."

#define GOTBLUECARD	"Picked up a blue keycard."
#define GOTREDCARD	"Picked up a red keycard."
#define GOTYELWCARD	"Picked up a yellow keycard."

#define GOTBLUESKUL	"Picked up a blue skull key."
#define GOTREDSKULL	"Picked up a red skull key."
#define GOTYELWSKUL	"Picked up a yellow skull key."

#define GOTCHAINSAW	"A chainsaw!  Find some meat!"
#define GOTBACKPACK	"Picked up a backpack full of ammo!"
#define GOTSUIT	"Radiation Shielding Suit"